14
19
7,3
1111111111111111111
1111140104111111111
1111103130140011111
1220100100100011111
1220103130100311111
1200100000130010411
1220003100103000011
1220100130130010011
1220103100000310011
1220100133130010011
1220103100100313001
1220100100100010001
1120111140111110041
1111111111111111111
