11
11
1,8
11111111111
11111110011
10000030011
10003110311
11312221011
11032220411
11012021011
11000101301
11300300041
11041111111
11111111111
