11
10
1,1
1111111111
1000414001
1030010301
1100003001
1110000111
1030001221
1033111221
1000001221
1000000041
1400000001
1111111111