10
14
4,7
11111111111111
12204140000111
12200103003001
12200131111001
12200000011001
12200101003011
11111101130301
11103003030301
11140001000001
11111111111111