16
19
1,2
1111111111111111111
1101111400000010001
1033000330030302221
1003331000030012221
1030001033033012221
1110001003000012221
1400001030303012221
1000011111101112221
1101001003030012221
1001101033030311221
1022101003000000121
1022101033303330121
1111101400000010121
1111101111111110121
1111140000000000121
1111111111111111111
