10
17
1,14
11111111111111111
11111111100000011
11111111103130111
11111111143003111
11111111113030111
11111111103010111
12222001103003001
11222000034030001
12222001111111111
11111111111111111
